SH5_102232_HM162296_reps	k__Fungi;p__Ascomycota;c__Sordariomycetes;o__Hypocreales;f__Clavicipitaceae;g__Metarhizium	0.36
SH5_107239_EU620132_reps	k__Fungi;p__Ascomycota;c__Sordariomycetes;o__Hypocreales;f__Clavicipitaceae;g__Metarhizium	0.31
SH5_113977_HQ392596_reps	k__Fungi;p__Ascomycota;c__Sordariomycetes;o__Hypocreales;f__Clavicipitaceae;g__Metarhizium	0.49
New.ReferenceOTU0	k__Fungi;p__Ascomycota;c__Dothideomycetes;o__Capnodiales;f__;g__Cystocoleus	0.31
New.ReferenceOTU1	k__Fungi;p__Ascomycota;c__Lecanoromycetes;o__Rhizocarpales;f__Catillariaceae;g__Austrolecia	0.18
New.ReferenceOTU10	k__Fungi;p__Ascomycota;c__Lecanoromycetes;o__Rhizocarpales;f__Catillariaceae;g__Austrolecia	0.21
New.ReferenceOTU11	k__Fungi;p__Ascomycota;c__Lecanoromycetes;o__Rhizocarpales;f__Catillariaceae;g__Austrolecia	0.28
New.ReferenceOTU12	k__Fungi;p__Ascomycota;c__Lecanoromycetes;o__Rhizocarpales;f__Catillariaceae;g__Austrolecia	0.24
New.ReferenceOTU13	k__Fungi;p__Ascomycota;c__Lecanoromycetes;o__Rhizocarpales;f__Catillariaceae;g__Austrolecia	0.28
New.ReferenceOTU15	k__Fungi;p__Ascomycota;c__Saccharomycetes;o__Saccharomycetales;f__Saccharomycetaceae;g__Debaryomyces	0.64
New.ReferenceOTU16	k__Fungi;p__Ascomycota;c__Saccharomycetes;o__Saccharomycetales;f__;g__	0.65
New.ReferenceOTU17	k__Fungi;p__Ascomycota;c__Dothideomycetes;o__Capnodiales;f__;g__Cystocoleus	0.23
New.ReferenceOTU2	k__Fungi;p__Ascomycota;c__Lecanoromycetes;o__Rhizocarpales;f__Catillariaceae;g__Austrolecia	0.21
New.ReferenceOTU3	k__Fungi;p__Ascomycota;c__Saccharomycetes;o__Saccharomycetales;f__Saccharomycetaceae;g__Zygosaccharomyces	0.49
New.ReferenceOTU4	k__Fungi;p__Ascomycota;c__Saccharomycetes;o__Saccharomycetales;f__Saccharomycetaceae;g__Zygosaccharomyces	0.67
New.ReferenceOTU5	k__Fungi;p__Ascomycota;c__Lecanoromycetes;o__Rhizocarpales;f__Catillariaceae;g__Austrolecia	0.28
New.ReferenceOTU6	k__Fungi;p__Ascomycota;c__Sordariomycetes;o__Microascales;f__Microascaceae;g__Microascus	0.31
New.ReferenceOTU7	k__Fungi;p__Ascomycota;c__Lecanoromycetes;o__Rhizocarpales;f__Catillariaceae;g__Austrolecia	0.27
New.ReferenceOTU8	k__Fungi;p__Ascomycota;c__Lecanoromycetes;o__Rhizocarpales;f__Catillariaceae;g__Austrolecia	0.23
New.ReferenceOTU9	k__Fungi;p__Ascomycota;c__Lecanoromycetes;o__Rhizocarpales;f__Catillariaceae;g__Austrolecia	0.21
New.CleanUp.ReferenceOTU1	k__Fungi;p__Ascomycota;c__Lecanoromycetes;o__Rhizocarpales;f__Catillariaceae;g__Austrolecia	0.19
New.CleanUp.ReferenceOTU112	k__Fungi;p__Ascomycota;c__Dothideomycetes;o__Capnodiales;f__;g__Cystocoleus	0.24
New.CleanUp.ReferenceOTU115	k__Fungi;p__Ascomycota;c__Dothideomycetes;o__Capnodiales;f__;g__Cystocoleus	0.29
New.CleanUp.ReferenceOTU117	k__Fungi;p__Ascomycota;c__Lecanoromycetes;o__Rhizocarpales;f__Catillariaceae;g__Austrolecia	0.30
New.CleanUp.ReferenceOTU128	k__Fungi;p__Ascomycota;c__Lecanoromycetes;o__Rhizocarpales;f__Catillariaceae;g__Austrolecia	0.44
New.CleanUp.ReferenceOTU131	k__Fungi;p__Ascomycota;c__Dothideomycetes;o__Capnodiales;f__;g__Cystocoleus	0.36
New.CleanUp.ReferenceOTU133	k__Fungi;p__Ascomycota;c__Saccharomycetes;o__Saccharomycetales;f__Saccharomycetaceae;g__Debaryomyces	0.58
New.CleanUp.ReferenceOTU140	k__Fungi;p__Ascomycota;c__Sordariomycetes;o__Hypocreales;f__Nectriaceae;g__Cyanonectria	0.22
New.CleanUp.ReferenceOTU150	k__Fungi;p__Ascomycota;c__Dothideomycetes;o__Capnodiales;f__;g__Cystocoleus	0.29
New.CleanUp.ReferenceOTU164	k__Fungi;p__Ascomycota;c__Lecanoromycetes;o__Rhizocarpales;f__Catillariaceae;g__Austrolecia	0.27
New.CleanUp.ReferenceOTU168	k__Fungi;p__Ascomycota;c__Sordariomycetes;o__Hypocreales;f__Clavicipitaceae;g__Metarhizium	0.20
New.CleanUp.ReferenceOTU171	k__Fungi;p__Ascomycota;c__Dothideomycetes;o__Capnodiales;f__;g__Cystocoleus	0.34
New.CleanUp.ReferenceOTU185	k__Fungi;p__Ascomycota;c__Lecanoromycetes;o__Rhizocarpales;f__Catillariaceae;g__Austrolecia	0.28
New.CleanUp.ReferenceOTU186	k__Fungi;p__Ascomycota;c__Dothideomycetes;o__Capnodiales;f__;g__Cystocoleus	0.19
New.CleanUp.ReferenceOTU190	k__Fungi;p__Ascomycota;c__Sordariomycetes;o__Hypocreales;f__Clavicipitaceae;g__Metarhizium	0.37
New.CleanUp.ReferenceOTU194	k__Fungi;p__Ascomycota;c__Dothideomycetes;o__Capnodiales;f__;g__Cystocoleus	0.26
New.CleanUp.ReferenceOTU196	k__Fungi;p__Ascomycota;c__Lecanoromycetes;o__Rhizocarpales;f__Catillariaceae;g__Austrolecia	0.24
New.CleanUp.ReferenceOTU201	k__Fungi;p__Ascomycota;c__Saccharomycetes;o__Saccharomycetales;f__;g__	0.37
New.CleanUp.ReferenceOTU203	k__Fungi;p__Ascomycota;c__Sordariomycetes;o__Hypocreales;f__Clavicipitaceae;g__Metarhizium	0.31
New.CleanUp.ReferenceOTU214	k__Fungi;p__Ascomycota;c__Lecanoromycetes;o__Rhizocarpales;f__Catillariaceae;g__Austrolecia	0.17
New.CleanUp.ReferenceOTU215	k__Fungi;p__Ascomycota;c__Sordariomycetes;o__Hypocreales;f__Clavicipitaceae;g__Metarhizium	0.16
New.CleanUp.ReferenceOTU242	k__Fungi;p__Ascomycota;c__Lecanoromycetes;o__Rhizocarpales;f__Catillariaceae;g__Austrolecia	0.17
New.CleanUp.ReferenceOTU248	k__Fungi;p__Ascomycota;c__Sordariomycetes;o__Hypocreales;f__Nectriaceae;g__Volutella	0.13
New.CleanUp.ReferenceOTU253	k__Fungi;p__Ascomycota;c__Dothideomycetes;o__Capnodiales;f__;g__Cystocoleus	0.16
New.CleanUp.ReferenceOTU260	k__Fungi;p__Ascomycota;c__Dothideomycetes;o__Capnodiales;f__;g__Cystocoleus	0.46
New.CleanUp.ReferenceOTU268	k__Fungi;p__Ascomycota;c__Lecanoromycetes;o__Rhizocarpales;f__Catillariaceae;g__Austrolecia	0.31
New.CleanUp.ReferenceOTU269	k__Fungi;p__Ascomycota;c__Dothideomycetes;o__Capnodiales;f__;g__Cystocoleus	0.24
New.CleanUp.ReferenceOTU279	k__Fungi;p__Ascomycota;c__Sordariomycetes;o__Hypocreales;f__Clavicipitaceae;g__Metarhizium	0.34
New.CleanUp.ReferenceOTU280	k__Fungi;p__Ascomycota;c__Lecanoromycetes;o__Rhizocarpales;f__Catillariaceae;g__Austrolecia	0.24
New.CleanUp.ReferenceOTU296	k__Fungi;p__Ascomycota;c__Dothideomycetes;o__Capnodiales;f__;g__Cystocoleus	0.24
New.CleanUp.ReferenceOTU302	k__Fungi;p__Ascomycota;c__Saccharomycetes;o__Saccharomycetales;f__Saccharomycetaceae;g__Zygosaccharomyces	0.46
New.CleanUp.ReferenceOTU312	k__Fungi;p__Ascomycota;c__Sordariomycetes;o__Microascales;f__Microascaceae;g__Microascus	0.29
New.CleanUp.ReferenceOTU32	k__Fungi;p__Ascomycota;c__Lecanoromycetes;o__Rhizocarpales;f__Catillariaceae;g__Austrolecia	0.31
New.CleanUp.ReferenceOTU324	k__Fungi;p__Ascomycota;c__Sordariomycetes;o__Diaporthales;f__Valsaceae;g__	0.21
New.CleanUp.ReferenceOTU34	k__Fungi;p__Ascomycota;c__Sordariomycetes;o__Hypocreales;f__Hypocreaceae;g__Gliocephalotrichum	0.21
New.CleanUp.ReferenceOTU36	k__Fungi;p__Ascomycota;c__Sordariomycetes;o__Microascales;f__Microascaceae;g__Doratomyces	0.24
New.CleanUp.ReferenceOTU364	k__Fungi;p__Ascomycota;c__Sordariomycetes;o__Hypocreales;f__Nectriaceae;g__Microcera	0.21
New.CleanUp.ReferenceOTU366	k__Fungi;p__Ascomycota;c__Sordariomycetes;o__Hypocreales;f__Hypocreaceae;g__Gliocephalotrichum	0.28
New.CleanUp.ReferenceOTU371	k__Fungi;p__Ascomycota;c__Dothideomycetes;o__Capnodiales;f__;g__Cystocoleus	0.27
New.CleanUp.ReferenceOTU38	k__Fungi;p__Ascomycota;c__Lecanoromycetes;o__Rhizocarpales;f__Catillariaceae;g__Austrolecia	0.28
New.CleanUp.ReferenceOTU4	k__Fungi;p__Ascomycota;c__Saccharomycetes;o__Saccharomycetales;f__Saccharomycetaceae;g__Debaryomyces	0.56
New.CleanUp.ReferenceOTU40	k__Fungi;p__Ascomycota;c__Eurotiomycetes;o__Eurotiales;f__Trichocomaceae;g__Emericella	0.45
New.CleanUp.ReferenceOTU45	k__Fungi;p__Ascomycota;c__Dothideomycetes;o__Capnodiales;f__;g__Cystocoleus	0.36
New.CleanUp.ReferenceOTU59	k__Fungi;p__Ascomycota;c__Dothideomycetes;o__Capnodiales;f__;g__Cystocoleus	0.24
New.CleanUp.ReferenceOTU60	k__Fungi;p__Ascomycota;c__Dothideomycetes;o__Capnodiales;f__;g__Cystocoleus	0.34
New.CleanUp.ReferenceOTU61	k__Fungi;p__Ascomycota;c__Saccharomycetes;o__Saccharomycetales;f__;g__	0.67
New.CleanUp.ReferenceOTU69	k__Fungi;p__Ascomycota;c__Lecanoromycetes;o__Rhizocarpales;f__Catillariaceae;g__Austrolecia	0.43
New.CleanUp.ReferenceOTU7	k__Fungi;p__Ascomycota;c__Sordariomycetes;o__Hypocreales;f__Nectriaceae;g__Microcera	0.20
New.CleanUp.ReferenceOTU76	k__Fungi;p__Ascomycota;c__Lecanoromycetes;o__Rhizocarpales;f__Catillariaceae;g__Austrolecia	0.35
New.CleanUp.ReferenceOTU84	k__Fungi;p__Ascomycota;c__Sordariomycetes;o__Hypocreales;f__Nectriaceae;g__Microcera	0.17
New.CleanUp.ReferenceOTU9	k__Fungi;p__Ascomycota;c__Sordariomycetes;o__Hypocreales;f__Nectriaceae;g__Microcera	0.20
New.CleanUp.ReferenceOTU96	k__Fungi;p__Ascomycota;c__Lecanoromycetes;o__Rhizocarpales;f__Catillariaceae;g__Austrolecia	0.27
New.CleanUp.ReferenceOTU98	k__Fungi;p__Ascomycota;c__Saccharomycetes;o__Saccharomycetales;f__;g__	0.61
