SH5_102232_HM162296_reps	k__Fungi;p__Ascomycota;c__Sordariomycetes;o__Hypocreales;f__Clavicipitaceae;g__Metarhizium	0.36
SH5_107239_EU620132_reps	k__Fungi;p__Ascomycota;c__Sordariomycetes;o__Hypocreales;f__Clavicipitaceae;g__Metarhizium	0.28
SH5_113977_HQ392596_reps	k__Fungi;p__Ascomycota;c__Sordariomycetes;o__Hypocreales;f__Clavicipitaceae;g__Metarhizium	0.55
New.ReferenceOTU0	k__Fungi;p__Ascomycota;c__Lecanoromycetes;o__Rhizocarpales;f__Catillariaceae;g__Austrolecia	0.17
New.ReferenceOTU1	k__Fungi;p__Ascomycota;c__Lecanoromycetes;o__Rhizocarpales;f__Catillariaceae;g__Austrolecia	0.24
New.ReferenceOTU10	k__Fungi;p__Ascomycota;c__Lecanoromycetes;o__Rhizocarpales;f__Catillariaceae;g__Austrolecia	0.31
New.ReferenceOTU11	k__Fungi;p__Ascomycota;c__Lecanoromycetes;o__Rhizocarpales;f__Catillariaceae;g__Austrolecia	0.23
New.ReferenceOTU12	k__Fungi;p__Ascomycota;c__Lecanoromycetes;o__Rhizocarpales;f__Catillariaceae;g__Austrolecia	0.20
New.ReferenceOTU2	k__Fungi;p__Ascomycota;c__Sordariomycetes;o__Hypocreales;f__Clavicipitaceae;g__Metarhizium	0.21
New.ReferenceOTU3	k__Fungi;p__Ascomycota;c__Lecanoromycetes;o__Rhizocarpales;f__Catillariaceae;g__Austrolecia	0.27
New.ReferenceOTU4	k__Fungi;p__Ascomycota;c__Lecanoromycetes;o__Rhizocarpales;f__Catillariaceae;g__Austrolecia	0.21
New.ReferenceOTU5	k__Fungi;p__Ascomycota;c__Dothideomycetes;o__Capnodiales;f__;g__Cystocoleus	0.24
New.ReferenceOTU6	k__Fungi;p__Ascomycota;c__Lecanoromycetes;o__Rhizocarpales;f__Catillariaceae;g__Austrolecia	0.22
New.ReferenceOTU7	k__Fungi;p__Ascomycota;c__Saccharomycetes;o__Saccharomycetales;f__Saccharomycetaceae;g__Debaryomyces	0.64
New.ReferenceOTU8	k__Fungi;p__Ascomycota;c__Dothideomycetes;o__Capnodiales;f__;g__Cystocoleus	0.26
New.ReferenceOTU9	k__Fungi;p__Ascomycota;c__Saccharomycetes;o__Saccharomycetales;f__;g__	0.63
New.CleanUp.ReferenceOTU1	k__Fungi;p__Ascomycota;c__Sordariomycetes;o__Hypocreales;f__Nectriaceae;g__Microcera	0.26
New.CleanUp.ReferenceOTU10	k__Fungi;p__Zygomycota;c__;o__Mucorales;f__Mucoraceae;g__Zygorhynchus	0.03
New.CleanUp.ReferenceOTU102	k__Fungi;p__Ascomycota;c__Lecanoromycetes;o__Rhizocarpales;f__Catillariaceae;g__Austrolecia	0.15
New.CleanUp.ReferenceOTU105	k__Fungi;p__Ascomycota;c__Saccharomycetes;o__Saccharomycetales;f__Saccharomycetaceae;g__Zygosaccharomyces	0.47
New.CleanUp.ReferenceOTU106	k__Fungi;p__Ascomycota;c__Lecanoromycetes;o__Rhizocarpales;f__Catillariaceae;g__Austrolecia	0.21
New.CleanUp.ReferenceOTU115	k__Fungi;p__Ascomycota;c__Sordariomycetes;o__Hypocreales;f__;g__Stachybotrys	0.27
New.CleanUp.ReferenceOTU116	k__Fungi;p__Ascomycota;c__Lecanoromycetes;o__Rhizocarpales;f__Catillariaceae;g__Austrolecia	0.27
New.CleanUp.ReferenceOTU117	k__Fungi;p__Ascomycota;c__Sordariomycetes;o__Microascales;f__Microascaceae;g__Microascus	0.29
New.CleanUp.ReferenceOTU129	k__Fungi;p__Ascomycota;c__Lecanoromycetes;o__Rhizocarpales;f__Catillariaceae;g__Austrolecia	0.28
New.CleanUp.ReferenceOTU13	k__Fungi;p__Ascomycota;c__Lecanoromycetes;o__Rhizocarpales;f__Catillariaceae;g__Austrolecia	0.29
New.CleanUp.ReferenceOTU134	k__Fungi;p__Ascomycota;c__Lecanoromycetes;o__Rhizocarpales;f__Catillariaceae;g__Austrolecia	0.32
New.CleanUp.ReferenceOTU137	k__Fungi;p__Basidiomycota;c__Agaricomycetes;o__Agaricales;f__Marasmiaceae;g__Chaetocalathus	0.05
New.CleanUp.ReferenceOTU138	k__Fungi;p__Ascomycota;c__Dothideomycetes;o__Capnodiales;f__;g__Cystocoleus	0.35
New.CleanUp.ReferenceOTU141	k__Fungi;p__Basidiomycota;c__Agaricomycetes;o__Hymenochaetales;f__Schizoporaceae;g__Basidioradulum	0.07
New.CleanUp.ReferenceOTU144	k__Fungi;p__Ascomycota;c__Sordariomycetes;o__Hypocreales;f__Clavicipitaceae;g__Metarhizium	0.23
New.CleanUp.ReferenceOTU146	k__Fungi;p__Ascomycota;c__Lecanoromycetes;o__Rhizocarpales;f__Catillariaceae;g__Austrolecia	0.27
New.CleanUp.ReferenceOTU166	k__Fungi;p__Basidiomycota;c__Agaricomycetes;o__Agaricales;f__Physalacriaceae;g__Mycaureola	0.10
New.CleanUp.ReferenceOTU167	k__Fungi;p__Ascomycota;c__Sordariomycetes;o__;f__Plectosphaerellaceae;g__Musicillium	0.03
New.CleanUp.ReferenceOTU170	k__Fungi;p__Ascomycota;c__Sordariomycetes;o__Hypocreales;f__Nectriaceae;g__Volutella	0.15
New.CleanUp.ReferenceOTU172	k__Fungi;p__Ascomycota;c__Saccharomycetes;o__Saccharomycetales;f__Saccharomycetaceae;g__Zygosaccharomyces	0.58
New.CleanUp.ReferenceOTU22	k__Fungi;p__Ascomycota;c__Eurotiomycetes;o__Eurotiales;f__Trichocomaceae;g__Emericella	0.46
New.CleanUp.ReferenceOTU23	k__Fungi;p__Basidiomycota;c__Ustilaginomycetes;o__Ustilaginales;f__Anthracoideaceae;g__Anthracoidea	0.04
New.CleanUp.ReferenceOTU27	k__Fungi;p__Ascomycota;c__Dothideomycetes;o__Capnodiales;f__;g__Cystocoleus	0.35
New.CleanUp.ReferenceOTU28	k__Fungi;p__Ascomycota;c__Lecanoromycetes;o__Rhizocarpales;f__Catillariaceae;g__Austrolecia	0.26
New.CleanUp.ReferenceOTU32	k__Fungi;p__Ascomycota;c__Lecanoromycetes;o__Rhizocarpales;f__Catillariaceae;g__Austrolecia	0.21
New.CleanUp.ReferenceOTU36	k__Fungi;p__Ascomycota;c__Sordariomycetes;o__Microascales;f__Microascaceae;g__Doratomyces	0.17
New.CleanUp.ReferenceOTU39	k__Fungi;p__Ascomycota;c__Dothideomycetes;o__Capnodiales;f__;g__Cystocoleus	0.08
New.CleanUp.ReferenceOTU4	k__Fungi;p__Zygomycota;c__;o__Mucorales;f__Mucoraceae;g__Parasitella	0.04
New.CleanUp.ReferenceOTU41	k__Fungi;p__Basidiomycota;c__Ustilaginomycetes;o__Ustilaginales;f__Anthracoideaceae;g__Anthracoidea	0.03
New.CleanUp.ReferenceOTU50	k__Fungi;p__Ascomycota;c__Dothideomycetes;o__Capnodiales;f__;g__Cystocoleus	0.34
New.CleanUp.ReferenceOTU52	k__Fungi;p__Ascomycota;c__Eurotiomycetes;o__Eurotiales;f__Trichocomaceae;g__Chromocleista	0.13
New.CleanUp.ReferenceOTU57	k__Fungi;p__Ascomycota;c__Dothideomycetes;o__Pleosporales;f__Tubeufiaceae;g__	0.03
New.CleanUp.ReferenceOTU59	k__Fungi;p__Ascomycota;c__Lecanoromycetes;o__Rhizocarpales;f__Catillariaceae;g__Austrolecia	0.26
New.CleanUp.ReferenceOTU61	k__Fungi;p__Ascomycota;c__Lecanoromycetes;o__Rhizocarpales;f__Catillariaceae;g__Austrolecia	0.27
New.CleanUp.ReferenceOTU64	k__Fungi;p__Ascomycota;c__Pezizomycetes;o__Pezizales;f__Morchellaceae;g__Mitrophora	0.07
New.CleanUp.ReferenceOTU72	k__Fungi;p__Ascomycota;c__Dothideomycetes;o__Capnodiales;f__;g__Cystocoleus	0.20
New.CleanUp.ReferenceOTU73	k__Fungi;p__Ascomycota;c__Lecanoromycetes;o__Rhizocarpales;f__Catillariaceae;g__Austrolecia	0.26
New.CleanUp.ReferenceOTU76	k__Fungi;p__Ascomycota;c__Dothideomycetes;o__Capnodiales;f__;g__Cystocoleus	0.31
New.CleanUp.ReferenceOTU77	k__Fungi;p__Ascomycota;c__Dothideomycetes;o__Capnodiales;f__;g__Cystocoleus	0.21
New.CleanUp.ReferenceOTU9	k__Fungi;p__Ascomycota;c__Lecanoromycetes;o__Rhizocarpales;f__Catillariaceae;g__Austrolecia	0.31
New.CleanUp.ReferenceOTU92	k__Fungi;p__Ascomycota;c__Lecanoromycetes;o__Rhizocarpales;f__Catillariaceae;g__Austrolecia	0.15
New.CleanUp.ReferenceOTU98	k__Fungi;p__Ascomycota;c__Lecanoromycetes;o__Rhizocarpales;f__Catillariaceae;g__Austrolecia	0.26
New.CleanUp.ReferenceOTU99	k__Fungi;p__Ascomycota;c__Lecanoromycetes;o__Rhizocarpales;f__Catillariaceae;g__Austrolecia	0.23
