AB236002	p__Ascomycota;c__Saccharomycetes;o__Saccharomycetales;f__Pichiaceae;g__Pichia;s__Pichia_burtonii	1.00
AF157596	p__Ascomycota;c__Saccharomycetes;o__Saccharomycetales;f__Dipodascaceae;g__Galactomyces;s__Galactomyces_geotrichum	0.42
AM410602	p__Ascomycota;c__Sordariomycetes;o__Hypocreales;f__Nectriaceae;g__Nectria;s__Nectria_cinnabarina	0.29
DQ267827	p__Ascomycota;c__Eurotiomycetes;o__Eurotiales;f__Trichocomaceae;g__Penicillium;s__Penicillium_concentricum	0.63
DQ674351	p__Ascomycota;c__Saccharomycetes;o__Saccharomycetales;f__Pichiaceae;g__Issatchenkia;s__Issatchenkia_sp_YS5	0.69
DQ681373	p__Ascomycota;c__Saccharomycetes;o__Saccharomycetales;f__Saccharomycetaceae;g__Debaryomyces;s__Debaryomyces_pseudopolymorphus	0.28
DQ683114	p__Ascomycota;c__Saccharomycetes;o__Saccharomycetales;f__Dipodascaceae;g__Galactomyces;s__Galactomyces_geotrichum	0.68
DQ980578	p__Ascomycota;c__Sordariomycetes;o__Hypocreales;f__Nectriaceae;g__Cyanonectria;s__Cyanonectria_buxi	0.61
EF199746	p__Ascomycota;c__Saccharomycetes;o__Saccharomycetales;f__Incertae_sedis;g__Candida;s__Candida_catenulata	0.97
EU490021	p__Ascomycota;c__Sordariomycetes;o__Hypocreales;f__Nectriaceae;g__Fusarium;s__Fusarium_sp_BBA_65925	0.19
EU551202	p__Ascomycota;c__Eurotiomycetes;o__Eurotiales;f__Trichocomaceae;g__Penicillium;s__Penicillium_concentricum	0.63
FJ196614	p__Ascomycota;c__Sordariomycetes;o__Hypocreales	0.54
FJ430772	p__Ascomycota;c__Eurotiomycetes;o__Eurotiales;f__Trichocomaceae;g__Penicillium;s__Penicillium_coprobium	0.38
FJ466715	p__Ascomycota;c__Sordariomycetes;o__Hypocreales;f__Nectriaceae;g__Nectria;s__Nectria_cinnabarina	0.37
FJ552897	p__Ascomycota;c__Eurotiomycetes;o__Eurotiales;f__Trichocomaceae;g__Penicillium;s__Penicillium_concentricum	0.41
FJ553653	p__Ascomycota;c__Sordariomycetes;o__Hypocreales;f__Clavicipitaceae;g__Claviceps;s__Claviceps_purpurea	0.11
FJ760777	p__Ascomycota;c__Sordariomycetes;o__Hypocreales;f__Nectriaceae;g__Nectria;s__Nectria_cinnabarina	0.27
FJ760911	p__Ascomycota;c__Sordariomycetes;o__Hypocreales;f__Bionectriaceae;g__Bionectria	0.25
FJ777353	p__Ascomycota;c__Incertae_sedis;o__Incertae_sedis;f__Incertae_sedis;g__Ilyonectria;s__Ilyonectria_macrodidyma	0.16
FM177661	p__Ascomycota;c__Saccharomycetes;o__Saccharomycetales;f__Pichiaceae;g__Pichia;s__Pichia_norvegensis	0.37
FN562059	p__Ascomycota;c__Sordariomycetes;o__Hypocreales;f__Nectriaceae;g__Fusarium;s__Fusarium_sp_472	0.49
FR799498	p__Ascomycota;c__Eurotiomycetes;o__Eurotiales;f__Trichocomaceae;g__Penicillium;s__Penicillium_paneum	0.22
FR799499	p__Ascomycota;c__Eurotiomycetes;o__Eurotiales;f__Trichocomaceae;g__Penicillium;s__Penicillium_concentricum	0.38
GQ229082	p__Ascomycota;c__Eurotiomycetes;o__Eurotiales;f__Trichocomaceae;g__Aspergillus;s__Aspergillus_versicolor	0.41
GQ376077	p__Ascomycota;c__Saccharomycetes;o__Saccharomycetales;f__Saccharomycetaceae;g__Kluyveromyces;s__Kluyveromyces_lactis	0.98
GQ379907	p__Ascomycota	0.96
GQ458026	p__Ascomycota;c__Eurotiomycetes;o__Eurotiales;f__Trichocomaceae;g__Penicillium;s__Penicillium_concentricum	0.68
GQ851780	p__Ascomycota;c__Eurotiomycetes;o__Eurotiales;f__Trichocomaceae;g__Penicillium;s__Penicillium_allii	0.13
GQ999201	p__Ascomycota;c__Eurotiomycetes;o__Eurotiales;f__Trichocomaceae;g__Penicillium;s__Penicillium_concentricum	0.40
GU054037	p__Ascomycota;c__Sordariomycetes;o__Microascales;f__Microascaceae;g__Microascus;s__Scopulariopsis_brevicaulis	0.60
GU187850	p__Ascomycota;c__unidentified;o__unidentified;f__unidentified;g__unidentified	0.10
GU187857	p__Ascomycota;c__Sordariomycetes;o__Hypocreales;f__Nectriaceae;g__Nectria;s__Nectria_albida	0.11
GU187864	p__Ascomycota;c__Eurotiomycetes;o__Eurotiales;f__Trichocomaceae;g__Penicillium	0.69
GU370744	p__Ascomycota;c__Saccharomycetes;o__Saccharomycetales;f__Pichiaceae;g__Pichia;s__Pichia_jadinii	0.88
GU565140	p__Ascomycota;c__Eurotiomycetes;o__Eurotiales;f__Trichocomaceae;g__Penicillium;s__Penicillium_concentricum	0.23
GU566244	p__Ascomycota;c__Eurotiomycetes;o__Eurotiales;f__Trichocomaceae;g__Penicillium;s__Penicillium_concentricum	0.40
GU721258	p__Ascomycota;c__Sordariomycetes;o__Hypocreales;f__Nectriaceae;g__Fusarium	0.20
GU934594	p__Ascomycota;c__Eurotiomycetes;o__Eurotiales;f__Trichocomaceae;g__Penicillium;s__Penicillium_concentricum	0.72
HM037662	p__Ascomycota;c__Saccharomycetes;o__Saccharomycetales;f__Dipodascaceae;g__Galactomyces;s__Galactomyces_sp_3S_28C	0.86
HM069364	p__Ascomycota;c__unidentified;o__unidentified;f__unidentified;g__unidentified;s__ascomycete_sp_VTT_D_041022	0.24
HM069479	p__Ascomycota;c__Eurotiomycetes;o__Eurotiales;f__Trichocomaceae;g__Penicillium	0.77
HQ115737	p__Ascomycota;c__Saccharomycetes;o__Saccharomycetales;f__Dipodascaceae;g__Dipodascus;s__Dipodascus_australiensis	0.97
HQ124706	p__Ascomycota;c__Eurotiomycetes;o__Eurotiales;f__Trichocomaceae;g__Penicillium;s__Penicillium_paneum	0.32
HQ589260	p__Ascomycota;c__Saccharomycetes;o__Saccharomycetales;f__Pichiaceae;g__Issatchenkia;s__Issatchenkia_sp_YS5	0.79
HQ827787	p__Ascomycota;c__Eurotiomycetes;o__Eurotiales;f__Trichocomaceae;g__Penicillium;s__Penicillium_paneum	0.22
JF262912	p__Ascomycota	0.99
JF439501	p__Ascomycota;c__Eurotiomycetes;o__Eurotiales;f__Trichocomaceae;g__Penicillium;s__Penicillium_concentricum	0.51
JF449887	p__Ascomycota;c__Sordariomycetes;o__Hypocreales;f__Nectriaceae;g__Nectria;s__Nectria_cinnabarina	0.38
JF715197	p__Ascomycota;c__Saccharomycetes;o__Saccharomycetales;f__Pichiaceae;g__Issatchenkia;s__Issatchenkia_sp_YS5	0.62
JF720033	p__Ascomycota;c__Saccharomycetes;o__Saccharomycetales;f__Saccharomycetaceae;g__Debaryomyces;s__Debaryomyces_sp_R344	0.25
JF907594	p__Ascomycota;c__Saccharomycetes;o__Saccharomycetales;f__Dipodascaceae;g__Galactomyces;s__Galactomyces_geotrichum	0.72
JF933755	p__Ascomycota;c__Sordariomycetes;o__Hypocreales;f__Nectriaceae;g__Nectria;s__Nectria_cinnabarina	0.27
JN905480	p__Ascomycota;c__unidentified;o__unidentified;f__unidentified;g__unidentified;s__ascomycete_sp_VTT_D_041022	0.20
JN905595	p__Ascomycota;c__Sordariomycetes;o__Hypocreales;f__Nectriaceae;g__Nectria;s__Nectria_cinnabarina	0.24
JQ912669	p__Ascomycota;c__Sordariomycetes;o__Hypocreales;f__Nectriaceae;g__Fusarium;s__Fusarium_sp_JJP_2009a	0.38
New.ReferenceOTU0	p__Ascomycota;c__Saccharomycetes;o__Saccharomycetales;f__Saccharomycetaceae;g__Zygosaccharomyces;s__Zygosaccharomyces_pseudorouxii	0.79
New.ReferenceOTU1	p__Ascomycota;c__Saccharomycetes;o__Saccharomycetales;f__Dipodascaceae;g__Galactomyces;s__Galactomyces_geotrichum	0.68
New.ReferenceOTU2	p__Ascomycota;c__Saccharomycetes;o__Saccharomycetales;f__Dipodascaceae;g__Galactomyces;s__Galactomyces_geotrichum	0.67
New.ReferenceOTU3	p__Ascomycota;c__Saccharomycetes;o__Saccharomycetales;f__Dipodascaceae;g__Galactomyces;s__Galactomyces_geotrichum	0.73
New.ReferenceOTU4	p__Ascomycota;c__Saccharomycetes;o__Saccharomycetales;f__Dipodascaceae;g__Galactomyces;s__Galactomyces_geotrichum	0.52
New.ReferenceOTU5	p__Ascomycota;c__Saccharomycetes;o__Saccharomycetales;f__Dipodascaceae;g__Galactomyces	0.27
New.CleanUp.ReferenceOTU1	p__Ascomycota;c__Saccharomycetes;o__Saccharomycetales;f__Dipodascaceae;g__Galactomyces;s__Galactomyces_geotrichum	0.44
New.CleanUp.ReferenceOTU10	p__Ascomycota;c__Saccharomycetes;o__Saccharomycetales;f__Pichiaceae;g__Pichia;s__Pichia_jadinii	0.49
New.CleanUp.ReferenceOTU102	p__Ascomycota;c__Saccharomycetes;o__Saccharomycetales;f__Dipodascaceae;g__Galactomyces;s__Galactomyces_geotrichum	0.10
New.CleanUp.ReferenceOTU109	p__Ascomycota;c__Saccharomycetes;o__Saccharomycetales;f__Pichiaceae;g__Issatchenkia;s__Issatchenkia_sp_YS5	0.58
New.CleanUp.ReferenceOTU116	p__Ascomycota;c__Saccharomycetes;o__Saccharomycetales;f__Dipodascaceae;g__Galactomyces;s__Galactomyces_geotrichum	0.23
New.CleanUp.ReferenceOTU118	p__Ascomycota;c__Saccharomycetes;o__Saccharomycetales;f__Pichiaceae;g__Issatchenkia;s__Issatchenkia_sp_YS5	0.75
New.CleanUp.ReferenceOTU132	p__Ascomycota;c__Saccharomycetes;o__Saccharomycetales;f__Pichiaceae;g__Pichia;s__Pichia_jadinii	0.45
New.CleanUp.ReferenceOTU136	p__Ascomycota;c__Saccharomycetes;o__Saccharomycetales;f__Dipodascaceae;g__Galactomyces;s__Galactomyces_geotrichum	0.32
New.CleanUp.ReferenceOTU140	p__Ascomycota;c__Saccharomycetes;o__Saccharomycetales;f__Dipodascaceae;g__Galactomyces;s__Galactomyces_geotrichum	0.70
New.CleanUp.ReferenceOTU142	p__Ascomycota;c__Saccharomycetes;o__Saccharomycetales;f__Dipodascaceae;g__Galactomyces;s__Galactomyces_geotrichum	0.15
New.CleanUp.ReferenceOTU145	p__Ascomycota;c__Saccharomycetes;o__Saccharomycetales;f__Incertae_sedis;g__Candida;s__Candida_catenulata	0.71
New.CleanUp.ReferenceOTU154	p__Ascomycota;c__Saccharomycetes;o__Saccharomycetales;f__Dipodascaceae;g__Galactomyces;s__Galactomyces_sp_3S_28C	0.24
New.CleanUp.ReferenceOTU157	p__Ascomycota;c__Saccharomycetes;o__Saccharomycetales;f__Dipodascaceae;g__Galactomyces;s__Galactomyces_reessii	0.17
New.CleanUp.ReferenceOTU160	p__Ascomycota;c__Saccharomycetes;o__Saccharomycetales;f__Dipodascaceae;g__Galactomyces;s__Galactomyces_geotrichum	0.48
New.CleanUp.ReferenceOTU165	p__Ascomycota;c__Saccharomycetes;o__Saccharomycetales;f__Pichiaceae;g__Issatchenkia;s__Issatchenkia_sp_YS5	0.28
New.CleanUp.ReferenceOTU167	p__Ascomycota;c__unidentified;o__unidentified;f__unidentified;g__unidentified;s__ascomycete_sp_VTT_D_041022	0.14
New.CleanUp.ReferenceOTU174	p__Ascomycota;c__Saccharomycetes;o__Saccharomycetales;f__Dipodascaceae;g__Galactomyces;s__Galactomyces_sp_3S_28C	0.31
New.CleanUp.ReferenceOTU178	p__Ascomycota;c__Saccharomycetes;o__Saccharomycetales;f__Dipodascaceae;g__Galactomyces;s__Galactomyces_geotrichum	0.59
New.CleanUp.ReferenceOTU179	p__Ascomycota;c__Saccharomycetes;o__Saccharomycetales;f__Pichiaceae;g__Issatchenkia;s__Issatchenkia_sp_YS5	0.44
New.CleanUp.ReferenceOTU180	p__Ascomycota;c__Eurotiomycetes;o__Eurotiales;f__Trichocomaceae;g__Penicillium;s__Penicillium_paneum	0.26
New.CleanUp.ReferenceOTU196	p__Ascomycota;c__Saccharomycetes;o__Saccharomycetales;f__Dipodascaceae;g__Galactomyces;s__Galactomyces_sp_3S_28C	0.15
New.CleanUp.ReferenceOTU199	p__Ascomycota;c__Saccharomycetes;o__Saccharomycetales;f__Pichiaceae;g__Issatchenkia;s__Issatchenkia_sp_YS5	0.48
New.CleanUp.ReferenceOTU201	p__Ascomycota;c__Saccharomycetes;o__Saccharomycetales;f__Pichiaceae;g__Issatchenkia;s__Issatchenkia_sp_YS5	0.51
New.CleanUp.ReferenceOTU202	p__Ascomycota;c__Saccharomycetes;o__Saccharomycetales;f__Incertae_sedis;g__Candida;s__Candida_catenulata	0.90
New.CleanUp.ReferenceOTU204	p__Ascomycota;c__Sordariomycetes;o__Microascales;f__Microascaceae;g__Scopulariopsis;s__Scopulariopsis_flava	0.49
New.CleanUp.ReferenceOTU205	p__Ascomycota;c__Saccharomycetes;o__Saccharomycetales;f__Dipodascaceae;g__Galactomyces;s__Galactomyces_geotrichum	0.49
New.CleanUp.ReferenceOTU206	p__Ascomycota;c__Saccharomycetes;o__Saccharomycetales;f__Pichiaceae;g__Issatchenkia;s__Issatchenkia_sp_YS5	0.44
New.CleanUp.ReferenceOTU209	p__Ascomycota;c__Saccharomycetes;o__Saccharomycetales;f__Dipodascaceae;g__Galactomyces;s__Galactomyces_geotrichum	0.36
New.CleanUp.ReferenceOTU210	p__Ascomycota;c__Saccharomycetes;o__Saccharomycetales;f__Pichiaceae;g__Pichia;s__Pichia_jadinii	0.78
New.CleanUp.ReferenceOTU215	p__Ascomycota;c__Saccharomycetes;o__Saccharomycetales;f__Dipodascaceae;g__Galactomyces;s__Galactomyces_geotrichum	0.54
New.CleanUp.ReferenceOTU229	p__Ascomycota;c__Saccharomycetes;o__Saccharomycetales;f__Pichiaceae;g__Pichia;s__Pichia_jadinii	0.68
New.CleanUp.ReferenceOTU231	p__Ascomycota;c__Saccharomycetes;o__Saccharomycetales;f__Dipodascaceae;g__unidentified;s__Dipodascaceae_sp_CPK3512	0.28
New.CleanUp.ReferenceOTU232	p__Ascomycota;c__Saccharomycetes;o__Saccharomycetales;f__Dipodascaceae;g__Galactomyces;s__Galactomyces_sp_3S_28C	0.21
New.CleanUp.ReferenceOTU236	p__Ascomycota;c__Saccharomycetes;o__Saccharomycetales;f__Incertae_sedis;g__Candida;s__Candida_catenulata	0.89
New.CleanUp.ReferenceOTU237	p__Ascomycota;c__Saccharomycetes;o__Saccharomycetales;f__Pichiaceae;g__Issatchenkia;s__Issatchenkia_sp_YS5	0.46
New.CleanUp.ReferenceOTU245	p__Ascomycota;c__Eurotiomycetes;o__Eurotiales;f__Trichocomaceae;g__Penicillium;s__Penicillium_paneum	0.29
New.CleanUp.ReferenceOTU246	p__Ascomycota;c__Saccharomycetes;o__Saccharomycetales;f__Pichiaceae;g__Issatchenkia;s__Issatchenkia_sp_YS5	0.71
New.CleanUp.ReferenceOTU249	p__Ascomycota;c__Saccharomycetes;o__Saccharomycetales;f__Pichiaceae;g__Issatchenkia;s__Issatchenkia_sp_YS5	0.39
New.CleanUp.ReferenceOTU250	p__Ascomycota;c__Saccharomycetes;o__Saccharomycetales;f__Incertae_sedis;g__Candida;s__Candida_catenulata	0.89
New.CleanUp.ReferenceOTU253	p__Ascomycota;c__Saccharomycetes;o__Saccharomycetales;f__Pichiaceae;g__Issatchenkia;s__Issatchenkia_sp_YS5	0.54
New.CleanUp.ReferenceOTU257	p__Ascomycota;c__Saccharomycetes;o__Saccharomycetales;f__Dipodascaceae;g__Galactomyces;s__Galactomyces_geotrichum	0.33
New.CleanUp.ReferenceOTU266	p__Ascomycota;c__Saccharomycetes;o__Saccharomycetales;f__Pichiaceae;g__Issatchenkia;s__Issatchenkia_sp_YS5	0.28
New.CleanUp.ReferenceOTU270	p__Ascomycota;c__Eurotiomycetes;o__Eurotiales;f__Trichocomaceae;g__Penicillium	0.67
New.CleanUp.ReferenceOTU282	p__Ascomycota;c__Eurotiomycetes;o__Eurotiales;f__Trichocomaceae;g__Penicillium	0.57
New.CleanUp.ReferenceOTU308	p__Ascomycota;c__Saccharomycetes;o__Saccharomycetales;f__Pichiaceae;g__Issatchenkia;s__Issatchenkia_sp_YS5	0.65
New.CleanUp.ReferenceOTU309	p__Ascomycota;c__Saccharomycetes;o__Saccharomycetales;f__Dipodascaceae;g__Galactomyces;s__Galactomyces_sp_3S_28C	0.75
New.CleanUp.ReferenceOTU310	p__Ascomycota;c__Sordariomycetes;o__Microascales;f__Microascaceae;g__Microascus;s__Scopulariopsis_brevicaulis	0.14
New.CleanUp.ReferenceOTU322	p__Ascomycota;c__Saccharomycetes;o__Saccharomycetales;f__Dipodascaceae;g__Dipodascus;s__Dipodascus_australiensis	0.53
New.CleanUp.ReferenceOTU323	p__Ascomycota	0.89
New.CleanUp.ReferenceOTU326	p__Ascomycota;c__Saccharomycetes;o__Saccharomycetales;f__Dipodascaceae;g__Galactomyces;s__Galactomyces_geotrichum	0.29
New.CleanUp.ReferenceOTU327	p__Ascomycota;c__Saccharomycetes;o__Saccharomycetales;f__Pichiaceae;g__Pichia;s__Pichia_jadinii	0.45
New.CleanUp.ReferenceOTU336	p__Ascomycota;c__Sordariomycetes;o__Microascales;f__Microascaceae;g__Microascus;s__Scopulariopsis_brevicaulis	0.38
New.CleanUp.ReferenceOTU337	p__Ascomycota;c__Saccharomycetes;o__Saccharomycetales;f__Saccharomycetaceae;g__Debaryomyces;s__Debaryomyces_sp_R344	0.16
New.CleanUp.ReferenceOTU340	p__Ascomycota;c__Saccharomycetes;o__Saccharomycetales;f__Pichiaceae;g__Issatchenkia;s__Issatchenkia_sp_YS5	0.49
New.CleanUp.ReferenceOTU354	p__Ascomycota;c__Saccharomycetes;o__Saccharomycetales;f__Dipodascaceae;g__Galactomyces;s__Galactomyces_sp_3S_28C	0.24
New.CleanUp.ReferenceOTU36	p__Ascomycota;c__Eurotiomycetes;o__Eurotiales;f__Trichocomaceae;g__Penicillium;s__Penicillium_sp_LH185	0.12
New.CleanUp.ReferenceOTU363	p__Ascomycota;c__Saccharomycetes;o__Saccharomycetales;f__Pichiaceae;g__Issatchenkia;s__Issatchenkia_sp_YS5	0.57
New.CleanUp.ReferenceOTU371	p__Ascomycota;c__Sordariomycetes;o__Microascales;f__Microascaceae;g__Scopulariopsis;s__Scopulariopsis_flava	0.34
New.CleanUp.ReferenceOTU373	p__Ascomycota;c__Saccharomycetes;o__Saccharomycetales;f__Pichiaceae;g__Issatchenkia;s__Issatchenkia_sp_YS5	0.49
New.CleanUp.ReferenceOTU376	p__Ascomycota;c__Saccharomycetes;o__Saccharomycetales;f__Dipodascaceae;g__Galactomyces;s__Galactomyces_geotrichum	0.80
New.CleanUp.ReferenceOTU379	p__Ascomycota;c__Saccharomycetes;o__Saccharomycetales;f__Pichiaceae;g__Pichia;s__Pichia_jadinii	0.75
New.CleanUp.ReferenceOTU38	p__Ascomycota;c__Sordariomycetes;o__Hypocreales	0.65
New.CleanUp.ReferenceOTU380	p__unidentified;c__unidentified;o__unidentified;f__unidentified;g__unidentified;s__unculturedcompost_fungus	0.11
New.CleanUp.ReferenceOTU395	p__Ascomycota;c__Saccharomycetes;o__Saccharomycetales;f__Saccharomycetaceae;g__Zygosaccharomyces;s__Zygosaccharomyces_pseudorouxii	0.91
New.CleanUp.ReferenceOTU40	p__Ascomycota;c__Sordariomycetes;o__Microascales;f__Microascaceae;g__Scopulariopsis;s__Scopulariopsis_flava	0.72
New.CleanUp.ReferenceOTU413	p__Ascomycota;c__Saccharomycetes;o__Saccharomycetales;f__Pichiaceae;g__Issatchenkia;s__Issatchenkia_sp_YS5	0.64
New.CleanUp.ReferenceOTU42	p__Ascomycota;c__Saccharomycetes;o__Saccharomycetales;f__Dipodascaceae;g__Galactomyces;s__Galactomyces_geotrichum	0.81
New.CleanUp.ReferenceOTU424	p__Ascomycota;c__Saccharomycetes;o__Saccharomycetales;f__Pichiaceae;g__Pichia;s__Pichia_jadinii	0.90
New.CleanUp.ReferenceOTU425	p__Ascomycota;c__Saccharomycetes;o__Saccharomycetales;f__Pichiaceae;g__Pichia;s__Pichia_jadinii	0.82
New.CleanUp.ReferenceOTU426	p__Ascomycota;c__Saccharomycetes;o__Saccharomycetales;f__Pichiaceae;g__Pichia;s__Pichia_jadinii	0.66
New.CleanUp.ReferenceOTU43	p__Ascomycota;c__Sordariomycetes;o__Microascales;f__Microascaceae;g__Microascus;s__Scopulariopsis_brevicaulis	0.49
New.CleanUp.ReferenceOTU438	p__unidentified;c__unidentified;o__unidentified;f__unidentified;g__unidentified;s__fungal_sp_BMP2995	0.12
New.CleanUp.ReferenceOTU443	p__Ascomycota;c__Sordariomycetes;o__Incertae_sedis;f__Magnaporthaceae;g__Gaeumannomyces;s__Gaeumannomyces_graminis_var_tritici	0.15
New.CleanUp.ReferenceOTU47	p__Ascomycota;c__Saccharomycetes;o__Saccharomycetales;f__Pichiaceae;g__Issatchenkia;s__Issatchenkia_sp_YS5	0.76
New.CleanUp.ReferenceOTU49	p__Ascomycota;c__Eurotiomycetes;o__Eurotiales;f__Trichocomaceae;g__Penicillium	0.85
New.CleanUp.ReferenceOTU6	p__Ascomycota	1.00
New.CleanUp.ReferenceOTU61	p__Ascomycota;c__Sordariomycetes;o__Microascales;f__Microascaceae;g__Scopulariopsis;s__Scopulariopsis_flava	0.36
New.CleanUp.ReferenceOTU63	p__Ascomycota;c__Saccharomycetes;o__Saccharomycetales;f__Pichiaceae;g__Issatchenkia;s__Issatchenkia_sp_YS5	0.60
New.CleanUp.ReferenceOTU64	p__Ascomycota;c__Saccharomycetes;o__Saccharomycetales;f__Pichiaceae;g__Issatchenkia;s__Issatchenkia_sp_YS5	0.56
New.CleanUp.ReferenceOTU71	p__Ascomycota;c__Saccharomycetes;o__Saccharomycetales;f__Pichiaceae;g__Issatchenkia;s__Issatchenkia_sp_YS5	0.78
New.CleanUp.ReferenceOTU79	p__Ascomycota;c__Saccharomycetes;o__Saccharomycetales;f__Dipodascaceae;g__Galactomyces;s__Galactomyces_sp_3S_28C	0.34
New.CleanUp.ReferenceOTU89	p__Ascomycota;c__Saccharomycetes;o__Saccharomycetales;f__Dipodascaceae;g__Galactomyces;s__Galactomyces_sp_3S_28C	0.56
New.CleanUp.ReferenceOTU9	p__Ascomycota;c__Eurotiomycetes;o__Eurotiales;f__Trichocomaceae;g__Penicillium;s__Penicillium_concentricum	0.34
New.CleanUp.ReferenceOTU97	p__Ascomycota;c__Saccharomycetes;o__Saccharomycetales;f__Dipodascaceae;g__Galactomyces;s__Galactomyces_geotrichum	0.67
