New.ReferenceOTU0	k__Fungi;p__Ascomycota;c__Lecanoromycetes;o__;f__Coniocybaceae;g__Sclerophora;s__Sclerophora peronella	0.350
New.CleanUp.ReferenceOTU39	k__Fungi;p__Ascomycota;c__Eurotiomycetes;o__Chaetothyriales;f__Herpotrichiellaceae;g__Phialophora;s__Phialophora verrucosa	0.060
New.CleanUp.ReferenceOTU146	k__Fungi;p__Ascomycota;c__Eurotiomycetes;o__Chaetothyriales;f__Herpotrichiellaceae;g__Phialophora;s__Phialophora verrucosa	0.130
New.CleanUp.ReferenceOTU32	k__Fungi;p__Ascomycota;c__Lecanoromycetes;o__;f__Coniocybaceae;g__Sclerophora;s__Sclerophora peronella	0.180
New.CleanUp.ReferenceOTU98	k__Fungi;p__Ascomycota;c__Eurotiomycetes;o__Chaetothyriales;f__Herpotrichiellaceae;g__Phialophora;s__Phialophora verrucosa	0.010
New.CleanUp.ReferenceOTU1	k__Fungi;p__;c__;o__;f__;g__;s__fungal sp 212d	0.420
New.CleanUp.ReferenceOTU13	k__Fungi;p__Ascomycota;c__Eurotiomycetes;o__Chaetothyriales;f__Herpotrichiellaceae;g__Phialophora;s__Phialophora verrucosa	0.050
New.CleanUp.ReferenceOTU102	k__Fungi;p__Ascomycota;c__Lecanoromycetes;o__;f__Coniocybaceae;g__Sclerophora;s__Sclerophora peronella	0.250
New.CleanUp.ReferenceOTU50	k__Fungi;p__Ascomycota;c__Eurotiomycetes;o__Chaetothyriales;f__Herpotrichiellaceae;g__Phialophora;s__Phialophora verrucosa	0.220
New.CleanUp.ReferenceOTU76	k__Fungi;p__Ascomycota;c__Lecanoromycetes;o__;f__Coniocybaceae;g__Sclerophora;s__Sclerophora peronella	0.210
New.CleanUp.ReferenceOTU117	k__Fungi;p__Ascomycota;c__Sordariomycetes;o__Xylariales;f__Xylariaceae;g__Hypoxylon;s__Hypoxylon papillatum	0.240
New.ReferenceOTU6	k__Fungi;p__Ascomycota;c__Saccharomycetes;o__Saccharomycetales;f__;g__Candida;s__Candida catenulata	0.720
New.CleanUp.ReferenceOTU115	k__Fungi;p__;c__;o__;f__;g__;s__fungal sp 212d	0.390
New.CleanUp.ReferenceOTU23	k__Fungi;p__Ascomycota;c__Sordariomycetes;o__Xylariales;f__Xylariaceae;g__Hypoxylon;s__Hypoxylon perforatum	0.030
New.CleanUp.ReferenceOTU4	k__Fungi;p__Ascomycota;c__Leotiomycetes;o__Rhytismatales;f__Rhytismataceae;g__Lirula;s__Lirula exigua	0.060
New.ReferenceOTU1	k__Fungi;p__Ascomycota;c__Eurotiomycetes;o__Chaetothyriales;f__Herpotrichiellaceae;g__Phialophora;s__Phialophora verrucosa	0.070
New.CleanUp.ReferenceOTU99	k__Fungi;p__Ascomycota;c__Eurotiomycetes;o__Chaetothyriales;f__Herpotrichiellaceae;g__Phialophora;s__Phialophora verrucosa	0.140
New.ReferenceOTU9	k__Fungi;p__Ascomycota;c__Saccharomycetes;o__Saccharomycetales;f__;g__;s__Saccharomycetales sp	0.430
New.CleanUp.ReferenceOTU106	k__Fungi;p__Ascomycota;c__Saccharomycetes;o__Saccharomycetales;f__;g__Candida;s__Candida chilensis	0.060
New.ReferenceOTU8	k__Fungi;p__Ascomycota;c__Eurotiomycetes;o__Eurotiales;f__Trichocomaceae;g__Penicillium;s__Penicillium roqueforti	0.630
New.CleanUp.ReferenceOTU64	k__Fungi;p__Ascomycota;c__Pezizomycetes;o__Pezizales;f__Morchellaceae;g__Morchella;s__Morchella sp Mes_27	0.110
New.CleanUp.ReferenceOTU77	k__Fungi;p__Ascomycota;c__Saccharomycetes;o__Saccharomycetales;f__;g__Candida;s__Candida catenulata	0.700
New.ReferenceOTU11	k__Fungi;p__Ascomycota;c__Lecanoromycetes;o__;f__Coniocybaceae;g__Sclerophora;s__Sclerophora peronella	0.380
New.CleanUp.ReferenceOTU61	k__Fungi;p__Ascomycota;c__Lecanoromycetes;o__;f__Coniocybaceae;g__Sclerophora;s__Sclerophora peronella	0.230
New.CleanUp.ReferenceOTU28	k__Fungi;p__Ascomycota;c__Eurotiomycetes;o__Chaetothyriales;f__Herpotrichiellaceae;g__Phialophora;s__Phialophora verrucosa	0.110
New.CleanUp.ReferenceOTU10	k__Fungi;p__Basidiomycota;c__Agaricomycetes;o__Thelephorales;f__Thelephoraceae;g__Polyozellus;s__Polyozellus sp	0.030
New.CleanUp.ReferenceOTU116	k__Fungi;p__Ascomycota;c__Eurotiomycetes;o__Chaetothyriales;f__Herpotrichiellaceae;g__Phialophora;s__Phialophora verrucosa	0.090
SH5_102232_HM162296_reps	k__Fungi;p__;c__;o__;f__;g__;s__fungal sp 212d	0.480
SH5_107239_EU620132_reps	k__Fungi;p__;c__;o__;f__;g__;s__fungal sp 212d	0.360
New.ReferenceOTU10	k__Fungi;p__Ascomycota;c__Lecanoromycetes;o__;f__Coniocybaceae;g__Sclerophora;s__Sclerophora peronella	0.210
New.ReferenceOTU2	k__Fungi;p__;c__;o__;f__;g__;s__fungal sp 212d	0.420
New.CleanUp.ReferenceOTU27	k__Fungi;p__Ascomycota;c__Eurotiomycetes;o__Chaetothyriales;f__Herpotrichiellaceae;g__Phialophora;s__Phialophora verrucosa	0.040
New.CleanUp.ReferenceOTU138	k__Fungi;p__Ascomycota;c__Lecanoromycetes;o__;f__Coniocybaceae;g__Sclerophora;s__Sclerophora peronella	0.210
New.CleanUp.ReferenceOTU73	k__Fungi;p__Ascomycota;c__Lecanoromycetes;o__;f__Coniocybaceae;g__Sclerophora;s__Sclerophora peronella	0.150
New.CleanUp.ReferenceOTU137	k__Fungi;p__Basidiomycota;c__Pucciniomycetes;o__Pucciniales;f__Pucciniastraceae;g__Pucciniastrum;s__Pucciniastrum goeppertianum	0.050
New.CleanUp.ReferenceOTU41	k__Fungi;p__Ascomycota;c__Lecanoromycetes;o__Peltigerales;f__Lobariaceae;g__Pseudocyphellaria;s__Pseudocyphellaria cinnamomea	0.000
New.CleanUp.ReferenceOTU144	k__Fungi;p__;c__;o__;f__;g__;s__fungal sp 212d	0.520
New.CleanUp.ReferenceOTU170	k__Fungi;p__Ascomycota;c__;o__;f__;g__;s__uncultured Trichothecium	0.320
New.CleanUp.ReferenceOTU36	k__Fungi;p__Ascomycota;c__Sordariomycetes;o__Xylariales;f__Xylariaceae;g__Hypoxylon;s__Hypoxylon papillatum	0.180
New.CleanUp.ReferenceOTU92	k__Fungi;p__Ascomycota;c__Eurotiomycetes;o__Chaetothyriales;f__Herpotrichiellaceae;g__Phialophora;s__Phialophora verrucosa	0.050
New.CleanUp.ReferenceOTU167	k__Fungi;p__Basidiomycota;c__Agaricomycetes;o__Agaricales;f__Marasmiaceae;g__Crinipellis;s__Crinipellis cupreostipes	0.030
New.ReferenceOTU5	k__Fungi;p__Ascomycota;c__Lecanoromycetes;o__;f__Coniocybaceae;g__Sclerophora;s__Sclerophora peronella	0.170
New.CleanUp.ReferenceOTU141	k__Fungi;p__Basidiomycota;c__Agaricomycetes;o__Boletales;f__Paxillaceae;g__Alpova;s__Alpova sp	0.030
New.CleanUp.ReferenceOTU52	k__Fungi;p__Ascomycota;c__Pezizomycetes;o__Pezizales;f__Morchellaceae;g__Morchella;s__Morchella sp FS_2009a	0.020
New.CleanUp.ReferenceOTU129	k__Fungi;p__Ascomycota;c__Eurotiomycetes;o__Chaetothyriales;f__Herpotrichiellaceae;g__Phialophora;s__Phialophora verrucosa	0.020
New.CleanUp.ReferenceOTU9	k__Fungi;p__Ascomycota;c__Saccharomycetes;o__Saccharomycetales;f__;g__Candida;s__Candida catenulata	0.480
SH5_113977_HQ392596_reps	k__Fungi;p__;c__;o__;f__;g__;s__fungal sp 212d	0.460
New.ReferenceOTU3	k__Fungi;p__Ascomycota;c__Eurotiomycetes;o__Chaetothyriales;f__Herpotrichiellaceae;g__Phialophora;s__Phialophora verrucosa	0.130
New.CleanUp.ReferenceOTU105	k__Fungi;p__Ascomycota;c__Saccharomycetes;o__Saccharomycetales;f__Saccharomycetaceae;g__Zygosaccharomyces;s__Zygosaccharomyces rouxii	0.660
New.CleanUp.ReferenceOTU134	k__Fungi;p__Ascomycota;c__Eurotiomycetes;o__Chaetothyriales;f__Herpotrichiellaceae;g__Phialophora;s__Phialophora verrucosa	0.050
New.ReferenceOTU12	k__Fungi;p__Ascomycota;c__Saccharomycetes;o__Saccharomycetales;f__Pichiaceae;g__Pichia;s__Pichia jadinii	0.550
New.CleanUp.ReferenceOTU172	k__Fungi;p__Ascomycota;c__Saccharomycetes;o__Saccharomycetales;f__Saccharomycetaceae;g__Zygosaccharomyces;s__Zygosaccharomyces rouxii	0.810
New.ReferenceOTU7	k__Fungi;p__Ascomycota;c__Saccharomycetes;o__Saccharomycetales;f__Saccharomycetaceae;g__Debaryomyces;s__Debaryomyces occidentalis var persoonii	0.580
New.CleanUp.ReferenceOTU57	k__Fungi;p__Basidiomycota;c__Agaricomycetes;o__Agaricales;f__Cortinariaceae;g__;s__uncultured Galerina	0.050
New.CleanUp.ReferenceOTU22	k__Fungi;p__Ascomycota;c__Eurotiomycetes;o__Eurotiales;f__Trichocomaceae;g__Aspergillus;s__Aspergillus sydowii	0.300
New.CleanUp.ReferenceOTU166	k__Fungi;p__Basidiomycota;c__Agaricomycetes;o__Agaricales;f__Physalacriaceae;g__Mycaureola;s__Mycaureola dilseae	0.030
New.CleanUp.ReferenceOTU72	k__Fungi;p__Ascomycota;c__Eurotiomycetes;o__Eurotiales;f__Trichocomaceae;g__Penicillium;s__Penicillium commune	0.550
New.ReferenceOTU4	k__Fungi;p__Ascomycota;c__Eurotiomycetes;o__Chaetothyriales;f__Herpotrichiellaceae;g__Phialophora;s__Phialophora verrucosa	0.250
New.CleanUp.ReferenceOTU59	k__Fungi;p__Ascomycota;c__Eurotiomycetes;o__Chaetothyriales;f__Herpotrichiellaceae;g__Phialophora;s__Phialophora verrucosa	0.070
